Don Pedro's Revenge
An Interactive Fiction
Release 1 / Serial number 210520 / Inform 7 build 6M62 (I6/v6.34 lib 6/12N) SD

Deck of the Helene Marie
The two crews are embattled all around you, but your attention is reserved for your particular enemy: Don Pedro.

Out on the open deck with no impediments, free to advance or retreat, you decide to

>retreat
You protect yourself, but end up wedged in between two barrels.

Trapped between your barrels, you decide to

>leave
But you aren't in anything at the moment.

Trapped between your barrels, you decide to

>escape
That's not a verb I recognise.

Trapped between your barrels, you decide to

>advance
You push forward aggressively, making your way to the open deck.

Out on the open deck with no impediments, free to advance or retreat, you decide to

>advance
You push forward aggressively, making your way to the open deck.

Out on the open deck with no impediments, free to advance or retreat, you decide to

>attack
What do you want to attack?

Out on the open deck with no impediments, free to advance or retreat, you decide to

>attack don pedro
You can't see any such thing.

Out on the open deck with no impediments, free to advance or retreat, you decide to

>l
Deck of the Helene Marie
The two crews are embattled all around you, but your attention is reserved for your particular enemy: Don Pedro.

Out on the open deck with no impediments, free to advance or retreat, you decide to

>jump
You leap and swing yourself boldly up into the rigging, leaving your attackers beneath you.

Able to slice at your attackers but not to advance or retreat, you choose to

>test
>--> The following tests are available:
'test me'
Able to slice at your attackers but not to advance or retreat, you choose to

>test me
(Testing.)

Able to slice at your attackers but not to advance or retreat, you choose to [1] advance

You can't move forward from here, only slash.

Able to slice at your attackers but not to advance or retreat, you choose to [2] jump

You leap down from your position, into the middle of the deck.

Out on the open deck with no impediments, free to advance or retreat, you decide to [3] advance

You push forward aggressively, making your way to the open deck.

Out on the open deck with no impediments, free to advance or retreat, you decide to [4] retreat

You protect yourself, but end up wedged in between two barrels.

So securely boxed-in that you can really only parry or thrust, you try to [5] jump

You leap and swing yourself boldly up into the rigging, leaving your attackers beneath you.

Perched up here with the advantage of height (but little mobility), you attempt to [6] retreat

You can't move backward or parry very successfully from this position.

Able to slice at your attackers but not to advance or retreat, you choose to [7] retreat

You can't move backward or parry very successfully from this position.

Perched up here with the advantage of height (but little mobility), you attempt to [8] advance

You can't move forward from here, only slash.

Able to slice at your attackers but not to advance or retreat, you choose to